ZAZ = "countries/Zaporizhya.txt"
PON = "countries/Pontic Steppe.txt"
LVO = "countries/Lvov.txt"
KUS = "countries/Kursk.txt"
KIE = "countries/Kiev.txt"
DNI = "countries/Dnipro.txt"
KAM = "countries/Kamchatka.txt"
VLD = "countries/White_Movement.txt"
BLD = "countries/Belgorod.txt"
FTY = "countries/Free Territory.txt"
GEK = "countries/German Kameroon.txt"
COB = "countries/Belgish Congo.txt"
RUS = "countries/Russia.txt"
PRB = "countries/Baltic Union.txt"
ZAC = "countries/Transcaucasia.txt"
SAR = "countries/Saarbrucken.txt"
RIF = "countries/Rif Republic.txt"
BOC = "countries/Bosphorus.txt"
ANT = "countries/Anatolia.txt"
NFL = "countries/Newfoundland.txt"
GUO = "countries/Kuomintang.txt"
GUC = "countries/Guominjun.txt"
BEI = "countries/Beiyang.txt"
INF = "countries/Indochinese Union.txt"
YSV = "countries/Ysturt Territory.txt"
TAS = "countries/Tashkent.txt"
AFY = "countries/Afyon.txt"
APW = "countries/Apgabals Wilejka.txt"
VLS = "countries/Volchya Sotnya.txt"
ATU = "countries/Attu island.txt"
KOL = "countries/Russkoe Pravitelstvo.txt"
SYB = "countries/Taiga Syberia.txt"